10 10
..........
XX...XX...
X.K...G...
X..XXXXXXX
....X.....
XX..X.X.G.
....XXX...
XX...XX...
S........T
XX...XX...
